wall=▓▓
way=░░

▓▓▓▓▓▓▓▓▓▓▓▓▓▓▓▓▓▓▓▓▓▓▓▓▓▓▓▓▓▓▓▓▓▓▓▓▓▓▓▓▓▓▓▓▓▓▓▓▓▓▓▓▓▓▓▓▓▓▓▓▓▓
▓▓░░░░░░░░░░▓▓░░░░░░▓▓░░▓▓░░░░░░░░░░░░░░▓▓░░░░░░░░░░▓▓░░▓▓░░▓▓
▓▓▓▓▓▓░░▓▓▓▓▓▓░░▓▓░░▓▓░░▓▓░░▓▓░░▓▓▓▓▓▓░░▓▓░░▓▓▓▓▓▓░░▓▓░░▓▓░░▓▓
▓▓░░▓▓░░░░░░░░░░▓▓░░▓▓░░░░░░▓▓░░░░░░▓▓░░▓▓░░▓▓░░░░░░░░░░░░░░▓▓
▓▓░░▓▓▓▓▓▓░░▓▓▓▓▓▓▓▓▓▓▓▓▓▓▓▓▓▓░░▓▓▓▓▓▓▓▓▓▓░░▓▓░░▓▓░░▓▓░░▓▓▓▓▓▓
▓▓░░░░░░░░░░▓▓░░░░░░▓▓░░▓▓░░▓▓░░░░░░▓▓░░▓▓░░▓▓░░▓▓░░▓▓░░░░░░▓▓
▓▓░░▓▓░░▓▓░░▓▓░░▓▓░░▓▓░░▓▓░░▓▓░░▓▓▓▓▓▓░░▓▓░░▓▓▓▓▓▓▓▓▓▓▓▓▓▓░░▓▓
▓▓░░▓▓░░▓▓░░▓▓░░▓▓░░░░░░░░░░▓▓░░░░░░░░░░░░░░░░░░▓▓░░▓▓░░▓▓░░▓▓
▓▓▓▓▓▓▓▓▓▓░░▓▓▓▓▓▓░░▓▓▓▓▓▓▓▓▓▓▓▓▓▓▓▓▓▓▓▓▓▓▓▓▓▓░░▓▓░░▓▓░░▓▓░░▓▓
▓▓░░▓▓░░░░░░▓▓░░▓▓░░░░░░░░░░▓▓░░░░░░▓▓░░░░░░▓▓░░░░░░▓▓░░░░░░▓▓
▓▓░░▓▓▓▓▓▓░░▓▓░░▓▓░░▓▓▓▓▓▓░░▓▓░░▓▓▓▓▓▓▓▓▓▓░░▓▓░░▓▓░░▓▓▓▓▓▓▓▓▓▓
▓▓░░░░░░▓▓░░░░░░▓▓░░░░░░▓▓░░░░░░░░░░░░░░░░░░░░░░▓▓░░░░░░░░░░▓▓
▓▓░░▓▓▓▓▓▓▓▓▓▓░░▓▓▓▓▓▓░░▓▓░░▓▓▓▓▓▓░░▓▓▓▓▓▓░░▓▓▓▓▓▓░░▓▓▓▓▓▓░░▓▓
▓▓░░░░░░░░░░▓▓░░░░░░░░░░▓▓░░▓▓░░▓▓░░▓▓░░░░░░▓▓░░░░░░░░░░▓▓░░▓▓
▓▓░░▓▓░░▓▓▓▓▓▓▓▓▓▓▓▓▓▓▓▓▓▓▓▓▓▓░░▓▓▓▓▓▓▓▓▓▓▓▓▓▓░░▓▓▓▓▓▓░░▓▓▓▓▓▓
▓▓░░▓▓░░▓▓░░░░░░░░░░▓▓░░▓▓░░░░░░▓▓░░░░░░▓▓░░▓▓░░▓▓░░▓▓░░░░░░▓▓
▓▓▓▓▓▓░░▓▓▓▓▓▓▓▓▓▓░░▓▓░░▓▓░░▓▓▓▓▓▓░░▓▓░░▓▓░░▓▓░░▓▓░░▓▓▓▓▓▓░░▓▓
▓▓░░░░░░▓▓░░░░░░▓▓░░░░░░░░░░░░░░▓▓░░▓▓░░░░░░░░░░░░░░░░░░▓▓░░▓▓
▓▓░░▓▓░░▓▓▓▓▓▓░░▓▓░░▓▓▓▓▓▓░░▓▓░░▓▓▓▓▓▓░░▓▓░░▓▓░░▓▓▓▓▓▓░░▓▓░░▓▓
▓▓░░▓▓░░░░░░░░░░░░░░░░░░▓▓░░▓▓░░▓▓░░▓▓░░▓▓░░▓▓░░▓▓░░░░░░▓▓░░▓▓
▓▓░░▓▓░░▓▓░░▓▓▓▓▓▓░░▓▓░░▓▓▓▓▓▓░░▓▓░░▓▓░░▓▓░░▓▓▓▓▓▓▓▓▓▓░░▓▓▓▓▓▓
▓▓░░▓▓░░▓▓░░▓▓░░░░░░▓▓░░▓▓░░▓▓░░░░░░░░░░▓▓░░▓▓░░░░░░░░░░░░░░▓▓
▓▓░░▓▓▓▓▓▓▓▓▓▓▓▓▓▓░░▓▓▓▓▓▓░░▓▓░░▓▓▓▓▓▓▓▓▓▓▓▓▓▓░░▓▓░░▓▓░░▓▓░░▓▓
▓▓░░░░░░░░░░░░░░▓▓░░▓▓░░░░░░▓▓░░▓▓░░▓▓░░░░░░░░░░▓▓░░▓▓░░▓▓░░▓▓
▓▓░░▓▓▓▓▓▓▓▓▓▓▓▓▓▓░░▓▓░░▓▓▓▓▓▓░░▓▓░░▓▓▓▓▓▓░░▓▓▓▓▓▓▓▓▓▓░░▓▓░░▓▓
▓▓░░▓▓░░▓▓░░▓▓░░▓▓░░░░░░▓▓░░▓▓░░░░░░▓▓░░░░░░░░░░░░░░▓▓░░▓▓░░▓▓
▓▓░░▓▓░░▓▓░░▓▓░░▓▓▓▓▓▓▓▓▓▓░░▓▓░░▓▓▓▓▓▓▓▓▓▓▓▓▓▓░░▓▓▓▓▓▓▓▓▓▓▓▓▓▓
▓▓░░▓▓░░░░░░░░░░░░░░░░░░░░░░░░░░▓▓░░░░░░░░░░░░░░▓▓░░░░░░░░░░▓▓
▓▓░░▓▓░░▓▓░░▓▓░░▓▓▓▓▓▓░░▓▓░░▓▓░░▓▓▓▓▓▓░░▓▓░░▓▓░░▓▓░░▓▓▓▓▓▓▓▓▓▓
▓▓░░▓▓░░▓▓░░▓▓░░░░░░▓▓░░▓▓░░▓▓░░░░░░▓▓░░▓▓░░▓▓░░░░░░░░░░░░░░▓▓
▓▓▓▓▓▓▓▓▓▓▓▓▓▓▓▓▓▓▓▓▓▓▓▓▓▓▓▓▓▓▓▓▓▓▓▓▓▓▓▓▓▓▓▓▓▓▓▓▓▓▓▓▓▓▓▓▓▓▓▓▓▓
